GBGGGGGGGGGGGGGGGGGGGGGGGGGGBGSGGGGGGGGGGGGGGGGGGG
GGGGGGGGGGBGGGSGGSGGBGGBGSGGGGGRRRRRGBGGGGGGGGGGGB
GGGGGGGGGGGGGGGGGGGGGGGGGGGGGGGRRRRRBGGGGGGGGGGGGG
GGSGGGGGGGGGGGGGSGGGGGGBGGGBGGGRRRRRGGSSGGGGGGGSGG
GGGGGBGGGSGGBGGGSGGSSSGGGGGBGGGRRRRRGGSGBGBGBGGGGB
GSGGGGGGGBGGGGGGGGGGGGGGGBGGGGSRRRRRGGGBBBGGGGGBGG
GGBGGGGGGGGGGGGGGGGGGBGGBGGGGGGRRRRRGGGGGGGGGGGBGG
GGGSGGGGGGBGGGGGGGGGGGGBGGGGGGSRRRRRGGGGGGGGGGGSGG
GGGGGGBGGGGGGGGGGSGGGGGGGGGGGGGRRRRRGGGGSGGGGGGGGG
GGGSGGGGGGBGGBGGBGGGGGGGGGGGGGSRRRRRGGGSGSSGGGGBGG
GGBGSGGGGGGGGGBGGGGBGGGGGGGGGGGGRRRRRGGGGSBBGGSGGG
GGGGGGGGGGGBGGGGGGGGGGGGBGGGGGGGGRRRRRGGGGGBGGBSGG
GBGGGGGGSGSGGGGGSGGGGGGGGGGGGGGGGGRRRRRGGGGGGSGGGG
GBGGSGSGGGGGGGGGGGGBGGGGGGGGGSBGGGGRRRRRGGGGGGGSGS
GGGGBGSGGGGGGGSGGGGGGGGGGGGGGGGGGGGGRRRRRGGBGGGGGG
GGGGGGGGGGGGGGGGGGGGGGGGGGGGGGGGGGGGGRRRRRGGGGBGBG
BGGGGGGGGGGGGGBGGGGBGGGGGGGGGBGGGGGGGGRRRRRBGBGBGG
GGGGGGGGGBGGSGGGGGGGGSGGGGGGGGGGGBBBGGRRRRRRGGGGGG
SSGGGGGGBSGGGGBGGGSGGGGBGGGGBGGGBGGGGRRRRRRRRGGGGS
BGGGGGGGBGGBBBGGGGGGGGGSGGGBGGGGGGGGGRRRRRRRRRGGGG
GGGGGBGGGGBGGGGBGGGGGBGGGGGGGGGGGGGGRRRRRRRRRRRGGS
GGGGGGGGGGGGGGBGGGGGGGGGGSGSGGGGGGGGGRRRRRRRRRGGGG
GSGGGGGGGGGGGBGGGGGGGBGGGGGGGGGGBGGBGRRRRRRRRGBSGG
GGGGSGGGGGGGSSGGGGGBGGBGGGGGGGGGGSGGGGRRRRRRGSGGGG
GBGGGGGGGGGGGGBGGGGGGGBGGGGGSGGGGGGGGGRRRRRGGGGGGG
GGGGGGGGGGGGGGGGBGGGGSGGGGGGGGBGGGGGGRRRRRSGGGGGSG
GGGGGGGGGGGGSGGGGGGGSGGGGGGGGGGGGGGBRRRRRGGGSGGGGG
BGBGGGGGGGGGGGBGGGGGGGGGGGGBGGGGGGGGRRRRRBGGGGGGGS
GGGSGGGGBGGGGGGGGGGGGGGGGGGGGGBGGBGGRRRRRGGGGGGGBG
GGBGGGBGGGGGGGBGSGSGBBGGGSGGGGGGGGGGRRRRRGGGGSGGSB
GGGGGGGGGGGGGGGGGGGGBBGGGGGGGGGGGGGGRRRRRGGBGGGGGG
GGGGGGGGGGBGGGGGGGGBGGGGGGGGGGGGGGGGRRRRRGGGGGGGGG
GGSGGGGGBGGSGSGGGGGSGGGGSGBSGGGGGGGBRRRRRGGGGGGBGG
BGBGBSGGGGGGSGBBGGSBGGGGGGGGGRGSGGGGRRRRRGGGGGGGGB
GGBGGGGGGGSSRGGGGGGGGGSGSGGGRRRGGGGGRRRRRGGGGGGGBG
GGGGGGGGGGRRRRRGBGGGGGGGGGGRRRRRGGSRRRRRGGGGGGGGGG
GGGGGGGGGRRRRRRRGGGSGGGGGGGGRRRGGBRRRRRGBGGGGGBGSG
GGGSGGGGGRRRRRRRGGGGGGGGGGBGGRGGGRRRRRGGGGGGBSGGGB
GGGGGGSGRRRRRRRRRGGGSGGBGGGGGGGGRRRRRGGGGGGGGGGGGB
BGGGGGGGGRRRRRRRGGGGGSGGGGSGBGGRRRRRGGGGGBGSBGGGGB
BGGGGGBGGRRRRRRRGGGSGGGGGSGBGGRRRRRGGGBGGBGGGGBBSG
GGGGGGGGGGRRRRRGGGGGGGGGGGGGGRRRRRGGGGGGGBGGGGGGGG
GGGSBGGGGGGGRSGGGGGGSGBGGGGGRRRRRGGGGGGGGGGGGBGGGG
GGGGGGGGGGGGGBGBGGGGGGGGGGGRRRRRGGGGSGSSBBGGSBBBGG
GGBGSGGGGSGGGSGGGGGGGGGGGGRRRRRGGGGGGGGGSGGGGGGGGG
GGGGGGGGGGGGGGGGGGGGGGGGGGSGBGGGGGGGGGGGGGGGBGGGGG
GSGGBGGGGGGGGGGGGGGGGSGGGGGGGGGGBGBGGGGGGGGSGSGSBG
GGGGGGGGGGGGGGGGGGGGGGGGGGGGGGGGGGGSBGGGGGGGGGGGGB
GGGGGGGBGGGGGGGGGGGSGGGGGGGGGGBGBGGGGGGGSSGGGGGGGG
GBGGGBBGBGGGGGGGSGGGSGGGGGGGSGGBGGGGGGGGGGGSGGGGGG
